1 3 1026 1021 1008 
1 6 1008 677 599 489 527 1002 
2 5 677 777 986 780 949 
3 7 949 592 517 971 915 946 934 
1 8 576 831 230 107 567 770 759 1030 
2 11 107 706 696 965 699 805 973 989 828 796 942 
2 6 366 964 943 835 473 823 
2 4 949 944 958 918 
2 4 699 165 999 969 
2 6 935 561 816 418 433 868 
2 6 956 908 662 919 874 884 
1 9 884 874 635 178 704 607 180 111 617 
1 9 868 433 888 882 516 819 464 877 491 
2 6 366 927 492 898 583 111 
2 6 823 688 910 790 761 877 
2 6 366 974 734 980 969 956 
2 6 823 649 948 779 918 935 
1 12 1030 470 1024 702 982 297 972 950 645 924 383 942 
2 4 699 836 652 1012 
2 4 1012 1005 998 966 
2 3 1012 992 974 
3 4 956 737 800 828 
2 8 942 788 612 751 222 276 328 884 
2 3 957 511 649 
2 3 957 136 966 
2 4 957 967 410 949 
1 12 1002 1020 569 531 190 890 641 945 955 968 911 934 
2 8 934 247 774 314 904 922 894 868 
3 4 935 896 698 915 
